1111111111111
10010C0000CE1
1C0P011111001
100011E000001
1111111111111