1111111111111
1001000000CE1
100P011111001
100011E000001
1111111111111